                          
                          
  ##  ##  ##  ##  ##  ##  
  ##  ##  ##  ##  ##  ##  
  ##  ##  ##  ##  ##  ##  
  ##  ##  ##  ##  ##  ##  
  ##  ##  ##xx##  ##  ##  
  ##  ##  ##xx##  ##  ##  
  ##  ##  ##  ##  ##  ##  
  ##  ##          ##  ##  
  ##  ##          ##  ##  
          ##  ##          
          ##  ##          
##  ####          ####  ##
xx  ####          ####  xx
          ##  ##          
          ######          
  ##  ##  ######  ##  ##  
  ##  ##  ##  ##  ##  ##  
  ##  ##  ##  ##  ##  ##  
  ##  ##  ##  ##  ##  ##  
  ##  ##          ##  ##  
  ##  ##          ##  ##  
  ##  ##   ####   ##  ##  
           #  #           
           #  #           