      xx      xx          
      xx      xx          
  ##  xx      ##  ##  ##  
  ##  xx      ##  ##  ##  
  ##          ##  ##xx##  
  ##        ####  ##xx##  
      ##          xx      
      ##          xx      
,,    ##    xx    ##,,##xx
,,    ##    xx    ##,,##xx
,,,,      ##    xx  ,,    
,,,,      ##    xx  ,,    
  ######,,,,,,xx    ,,##  
  ######,,,,,,xx    ,,##  
      xx,,##  ##  ##  ##  
      xx,,##  ##  ##  ##  
xx##  xx  ##  ##      ##  
xx##  xx  ##  ##      ##  
  ##  ##  ######  ##  ##  
  ##  ##  ######  ##  ##  
  ##  ##  ######          
  ##  ##                  
  ##              ##  ##  
  ##       ####   ##  ##  
  ##  ##   #  #   ######  
  ##  ##   #  #   ######  